3 3 3 3 3 3 3 3 3 3 3 3 3 3 3 3 3 3 3 3 3 3 3 3 3
3 7 7 2 2 2 2 2 2 2 2 2 2 7 3 7 3 2 7 7 1 2 2 2 3
3 2 2 2 0 1 2 2 2 2 2 2 2 2 7 7 3 7 7 2 2 2 1 2 3
3 2 0 1 2 2 2 2 3 2 2 2 2 2 2 2 3 7 2 2 2 1 2 2 3
3 2 2 2 2 1 2 2 3 2 2 2 0 1 2 2 3 1 2 7 2 1 2 7 3
3 7 0 1 2 2 2 2 3 2 2 1 2 2 2 2 3 2 2 2 7 2 7 2 3
3 7 2 2 2 2 2 7 3 7 7 2 2 1 2 2 3 2 2 1 2 7 2 2 3
3 7 0 1 2 2 2 7 3 7 3 7 2 2 2 2 3 2 2 2 2 2 2 1 3
3 3 3 0 1 3 3 3 3 3 3 3 3 3 3 3 3 3 3 3 3 0 1 3 3
3 2 2 2 2 7 2 2 3 2 2 2 7 0 2 2 3 3 2 2 2 2 2 7 3
3 2 2 2 7 0 1 0 3 2 7 2 7 2 7 2 3 2 2 2 2 2 2 2 3
3 2 2 7 2 2 2 2 3 2 7 2 7 2 7 2 3 2 2 7 7 7 1 2 3
3 2 7 2 2 2 2 2 3 2 7 2 7 2 7 2 2 1 2 2 7 7 7 2 3
3 2 2 2 2 7 2 2 2 2 7 2 7 2 7 2 2 2 2 2 2 2 0 2 3
3 2 2 2 2 2 7 2 2 2 7 2 7 2 7 2 3 2 2 2 2 2 2 2 3
3 2 2 2 2 2 2 7 3 2 7 2 1 2 7 2 3 7 2 2 2 2 2 7 3
3 3 3 3 3 3 3 3 3 3 3 3 3 3 7 3 3 3 3 3 3 3 3 3 3